Period,Period#,# of trades,winning trades,winning percent,PorL,StrategyReturn,MarketReturn,Strategy vs Market,Strategy+2 vs M,# of long trades,long winning trades,long winning percent,# of short trades,short winning trades,short winning percent
11-16-2009--11-11-2010,36,30,18,60,33410.08,33.41008,9.3741570003,1,1,18,13,72.2222222222,12,5,41.6666666667
01-15-2010--01-10-2011,38,32,18,56.25,30232.32,30.23232,11.7388243576,1,1,21,13,61.9047619048,11,5,45.4545454545
12-16-2009--12-11-2010,37,33,18,54.5454545455,28964.66,28.96466,11.6212338594,1,1,22,13,59.0909090909,11,5,45.4545454545
07-09-2011--07-03-2012,56,22,8,36.3636363636,27007.62,27.00762,4.1236644692,1,1,15,5,33.3333333333,7,3,42.8571428571
03-21-2009--03-16-2010,28,18,11,61.1111111111,26008.37,26.00837,41.5491245136,0,0,9,6,66.6666666667,9,5,55.5555555556
07-14-2010--07-09-2011,44,24,14,58.3333333333,24991.04,24.99104,22.5707015896,1,1,19,12,63.1578947368,5,2,40
08-13-2010--08-08-2011,45,21,12,57.1428571429,24396.52,24.39652,3.6469393408,1,1,16,9,56.25,5,3,60
09-12-2010--09-07-2011,46,20,11,55,23343.68,23.34368,6.7157558552,1,1,16,9,56.25,4,2,50
10-17-2009--10-12-2010,35,25,14,56,22769.67,22.76967,6.5761909099,1,1,13,9,69.2307692308,12,5,41.6666666667
04-20-2009--04-15-2010,29,19,11,57.8947368421,22530.77,22.53077,45.3793599425,0,0,10,6,60,9,5,55.5555555556
01-31-2007--01-26-2008,2,9,4,44.4444444444,22188.18,22.18818,-7.4504347826,1,1,3,1,33.3333333333,6,3,50
03-02-2007--02-25-2008,3,9,4,44.4444444444,22188.18,22.18818,-0.9663229249,1,1,3,1,33.3333333333,6,3,50
06-09-2011--06-03-2012,55,22,7,31.8181818182,21920.05,21.92005,-0.9582689335,1,1,15,4,26.6666666667,7,3,42.8571428571
09-07-2011--09-01-2012,58,27,9,33.3333333333,21807.91,21.80791,17.3497381328,1,1,19,6,31.5789473684,8,3,37.5
02-14-2010--02-09-2011,39,27,14,51.8518518519,21674.96,21.67496,20.5294332058,1,1,21,13,61.9047619048,6,1,16.6666666667
06-19-2009--06-14-2010,31,18,10,55.5555555556,21529.32,21.52932,18.979791395,1,1,10,5,50,8,5,62.5
05-10-2011--05-04-2012,54,22,7,31.8181818182,20267.05,20.26705,0.8316773386,1,1,15,4,26.6666666667,7,3,42.8571428571
04-10-2011--04-04-2012,53,20,6,30,20121.11,20.12111,5.5865921788,1,1,15,4,26.6666666667,5,2,40
04-15-2010--04-10-2011,41,27,15,55.5555555556,19395.55,19.39555,9.5391211147,1,1,20,13,65,7,2,28.5714285714
08-18-2009--08-13-2010,33,23,12,52.1739130435,19316.34,19.31634,9.3046725199,1,1,12,8,66.6666666667,11,4,36.3636363636
12-06-2011--11-30-2012,61,31,12,38.7096774194,18657.47,18.65747,12.5891018533,1,1,17,6,35.2941176471,14,6,42.8571428571
05-01-2007--04-25-2008,5,14,5,35.7142857143,18261.52,18.26152,-6.1007600726,1,1,7,2,28.5714285714,7,3,42.8571428571
01-10-2011--01-05-2012,50,13,5,38.4615384615,17525.86,17.52586,0.8347771303,1,1,8,3,37.5,5,2,40
04-01-2007--03-26-2008,4,10,4,40,17433.94,17.43394,-6.3027574564,1,1,3,1,33.3333333333,7,3,42.8571428571
02-09-2011--02-04-2012,51,14,5,35.7142857143,17166.54,17.16654,1.7169555981,1,1,9,3,33.3333333333,5,2,40
08-08-2011--08-02-2012,57,24,8,33.3333333333,17101.96,17.10196,21.7174416533,0,1,16,5,31.25,8,3,37.5
03-11-2011--03-05-2012,52,15,5,33.3333333333,16949.43,16.94943,4.5169672883,1,1,11,4,36.3636363636,4,1,25
05-15-2010--05-10-2011,42,28,15,53.5714285714,16551.83,16.55183,19.23650724,0,1,20,13,65,8,2,25
06-14-2010--06-09-2011,43,28,15,53.5714285714,15222.88,15.22288,18.1638038883,0,1,20,13,65,8,2,25
06-30-2007--06-24-2008,7,19,6,31.5789473684,14817.45,14.81745,-13.5713815139,1,1,8,2,25,11,4,36.3636363636
10-07-2011--10-01-2012,59,28,9,32.1428571429,14578.5,14.5785,24.7472128597,0,0,18,6,33.3333333333,10,3,30
03-16-2010--03-11-2011,40,27,14,51.8518518519,14322.85,14.32285,12.3958422816,1,1,20,12,60,7,2,28.5714285714
05-31-2007--05-25-2008,6,16,5,31.25,13964.39,13.96439,-10.2269762588,1,1,8,2,25,8,3,37.5
05-20-2009--05-15-2010,30,19,10,52.6315789474,13825.79,13.82579,25.8313998453,0,0,10,5,50,9,5,55.5555555556
04-29-2013--04-24-2014,78,21,12,57.1428571429,12165.86,12.16586,17.9096045198,0,0,15,11,73.3333333333,6,1,16.6666666667
11-06-2011--10-31-2012,60,31,10,32.2580645161,11098.24,11.09824,11.9515285918,0,1,17,5,29.4117647059,14,5,35.7142857143
10-26-2013--10-21-2014,84,19,10,52.6315789474,10787.22,10.78722,10.1231345401,1,1,13,9,69.2307692308,6,1,16.6666666667
09-17-2009--09-12-2010,34,23,12,52.1739130435,10707.11,10.70711,4.5307079231,1,1,11,7,63.6363636364,12,5,41.6666666667
06-28-2013--06-23-2014,80,19,11,57.8947368421,10104.18,10.10418,22.1044757512,0,0,14,10,71.4285714286,5,1,20
02-19-2009--02-14-2010,27,20,11,55,9841.36,9.84136,38.1921438713,0,0,8,5,62.5,12,6,50
12-30-2012--12-25-2013,74,15,9,60,9607.55,9.60755,28.4530580718,0,0,12,8,66.6666666667,3,1,33.3333333333
05-29-2013--05-24-2014,79,19,11,57.8947368421,9315.69,9.31569,15.2100229996,0,0,13,10,76.9230769231,6,1,16.6666666667
07-28-2013--07-23-2014,81,19,11,57.8947368421,9292.33,9.29233,17.8243074915,0,0,14,10,71.4285714286,5,1,20
08-27-2013--08-22-2014,82,19,11,57.8947368421,9292.33,9.29233,21.9555501133,0,0,14,10,71.4285714286,5,1,20
09-26-2013--09-21-2014,83,20,11,55,8659,8.659,18.2745005598,0,0,14,10,71.4285714286,6,1,16.6666666667
01-01-2007--12-27-2007,1,7,2,28.5714285714,8467.89,8.46789,4.4563910306,1,1,3,1,33.3333333333,4,1,25
07-30-2007--07-24-2008,8,21,6,28.5714285714,6739.15,6.73915,-14.8391912064,1,1,8,2,25,13,4,30.7692307692
07-19-2009--07-14-2010,32,20,9,45,4750.55,4.75055,15.2631634273,0,0,10,5,50,10,4,40
10-12-2010--10-07-2011,47,19,9,47.3684210526,4613.89,4.61389,-1.1110161525,1,1,15,7,46.6666666667,4,2,50
01-29-2013--01-24-2014,75,18,10,55.5555555556,4248.53,4.24853,18.7375547591,0,0,15,9,60,3,1,33.3333333333
02-28-2013--02-23-2014,76,21,10,47.619047619,3695.21,3.69521,21.2914715388,0,0,15,9,60,6,1,16.6666666667
11-11-2010--11-06-2011,48,16,6,37.5,3392.59,3.39259,3.1619188556,1,1,12,4,33.3333333333,4,2,50
03-30-2013--03-25-2014,77,22,11,50,3282.29,3.28229,19.3912207626,0,0,16,10,62.5,6,1,16.6666666667
12-21-2008--12-16-2009,25,13,6,46.1538461538,3211.11,3.21111,28.0955662761,0,0,6,4,66.6666666667,7,2,28.5714285714
08-29-2007--08-23-2008,9,22,6,27.2727272727,2880.79,2.88079,-11.6214003003,1,1,9,2,22.2222222222,13,4,30.7692307692
01-20-2009--01-15-2010,26,15,7,46.6666666667,2628.3,2.6283,41.0450539903,0,0,8,5,62.5,7,2,28.5714285714
12-11-2010--12-06-2011,49,13,5,38.4615384615,1748.39,1.74839,1.3648041105,1,1,8,3,37.5,5,2,40
03-05-2012--02-28-2013,64,29,11,37.9310344828,543.55,0.54355,10.8665447898,0,0,15,5,33.3333333333,14,6,42.8571428571
11-30-2012--11-25-2013,73,14,7,50,-880.39,-0.88039,27.0655270655,0,0,11,6,54.5454545455,3,1,33.3333333333
04-04-2012--03-30-2013,65,25,10,40,-1037.96,-1.03796,12.0191620192,0,0,11,4,36.3636363636,14,6,42.8571428571
02-04-2012--01-29-2013,63,30,11,36.6666666667,-1276.72,-1.27672,12.0565265898,0,0,16,5,31.25,14,6,42.8571428571
10-31-2012--10-26-2013,72,14,7,50,-1282.66,-1.28266,24.4782454899,0,0,10,5,50,4,2,50
01-05-2012--12-30-2012,62,31,11,35.4838709677,-1584.37,-1.58437,9.3642611684,0,0,17,5,29.4117647059,14,6,42.8571428571
09-28-2007--09-22-2008,10,23,6,26.0869565217,-1774.96,-1.77496,-20.605583956,1,1,8,1,12.5,15,5,33.3333333333
11-25-2013--11-20-2014,85,22,9,40.9090909091,-1981.68,-1.98168,13.8127664286,0,0,16,8,50,6,1,16.6666666667
10-22-2008--10-17-2009,23,12,5,41.6666666667,-3847.03,-3.84703,20.2540033131,0,0,6,3,50,6,2,33.3333333333
11-21-2008--11-16-2009,24,12,5,41.6666666667,-3847.03,-3.84703,39.8516096579,0,0,6,3,50,6,2,33.3333333333
06-03-2012--05-29-2013,67,24,9,37.5,-4616.41,-4.61641,28.9773614364,0,0,14,5,35.7142857143,10,4,40
10-01-2012--09-26-2013,71,18,7,38.8888888889,-5976.26,-5.97626,17.5586269008,0,0,10,4,40,8,3,37.5
05-04-2012--04-29-2013,66,24,9,37.5,-6238.99,-6.23899,16.2773722628,0,0,13,5,38.4615384615,11,4,36.3636363636
08-02-2012--07-28-2013,69,22,8,36.3636363636,-6975.45,-6.97545,23.7631733021,0,0,13,5,38.4615384615,9,3,33.3333333333
12-27-2007--12-21-2008,13,19,5,26.3157894737,-8005.04,-8.00504,-40.279000474,1,1,7,1,14.2857142857,12,4,33.3333333333
11-27-2007--11-21-2008,12,20,5,25,-9569.85,-9.56985,-44.2238900189,1,1,8,1,12.5,12,4,33.3333333333
07-03-2012--06-28-2013,68,24,8,33.3333333333,-9598.42,-9.59842,16.7438069455,0,0,13,4,30.7692307692,11,4,36.3636363636
07-24-2008--07-19-2009,20,14,5,35.7142857143,-9786.78,-9.78678,-25.0019918732,1,1,5,2,40,9,3,33.3333333333
12-25-2013--12-20-2014,86,22,8,36.3636363636,-10182.26,-10.18226,12.3276495064,0,0,16,7,43.75,6,1,16.6666666667
09-01-2012--08-27-2013,70,19,7,36.8421052632,-10724.83,-10.72483,15.8122385308,0,0,10,4,40,9,3,33.3333333333
08-23-2008--08-18-2009,21,14,5,35.7142857143,-10999.75,-10.99975,-21.9579428211,1,1,5,2,40,9,3,33.3333333333
05-25-2008--05-20-2009,18,14,4,28.5714285714,-13677.35,-13.67735,-34.7252271744,1,1,3,1,33.3333333333,11,3,27.2727272727
09-22-2008--09-17-2009,22,13,5,38.4615384615,-15985.51,-15.98551,-11.9613670134,0,1,6,3,50,7,2,28.5714285714
10-28-2007--10-22-2008,11,23,5,21.7391304348,-16844.49,-16.84449,-41.2508921041,1,1,8,1,12.5,15,4,26.6666666667
01-26-2008--01-20-2009,14,17,3,17.6470588235,-18321.67,-18.32167,-40.4244306418,1,1,7,1,14.2857142857,10,2,20
02-25-2008--02-19-2009,15,17,3,17.6470588235,-18321.67,-18.32167,-43.0707055997,1,1,7,1,14.2857142857,10,2,20
03-26-2008--03-21-2009,16,19,4,21.0526315789,-19553.32,-19.55332,-42.4099099099,1,1,7,1,14.2857142857,12,3,25
06-24-2008--06-19-2009,19,13,3,23.0769230769,-21442.14,-21.44214,-29.8422135834,1,1,3,1,33.3333333333,10,2,20
04-25-2008--04-20-2009,17,16,3,18.75,-24539.9,-24.5399,-40.2363896848,1,1,4,0,0,12,3,25
,,,,,,,,,,,,,,,
,,,,,67.4418604651,,,54.6511627907,60.4651162791,,,,,,
