Period,Period#,# of trades,winning trades,winning percent,PorL,StrategyReturn,MarketReturn,Strategy vs Market,# of long trades,long winning trades,long winning percent,# of short trades,short winning trades,short winning percent
01-01-2007--12-27-2007,1,29,15,51.724137931,-5684.44,-5.68444,4.4563910306,0,10,4,40,19,11,57.8947368421
01-31-2007--01-26-2008,2,39,24,61.5384615385,41408.99,41.40899,-7.4504347826,1,10,4,40,29,20,68.9655172414
03-02-2007--02-25-2008,3,49,29,59.1836734694,42950.78,42.95078,-0.9663229249,1,18,7,38.8888888889,31,22,70.9677419355
04-01-2007--03-26-2008,4,63,38,60.3174603175,50447.1,50.4471,-6.3027574564,1,27,13,48.1481481481,36,25,69.4444444444
05-01-2007--04-25-2008,5,74,42,56.7567567568,26579.87,26.57987,-6.1007600726,1,36,17,47.2222222222,38,25,65.7894736842
05-31-2007--05-25-2008,6,84,43,51.1904761905,26141.18,26.14118,-10.2269762588,1,40,18,45,44,25,56.8181818182
06-30-2007--06-24-2008,7,94,49,52.1276595745,39790.01,39.79001,-13.5713815139,1,40,18,45,54,31,57.4074074074
07-30-2007--07-24-2008,8,102,53,51.9607843137,21045.74,21.04574,-14.8391912064,1,41,18,43.9024390244,61,35,57.3770491803
08-29-2007--08-23-2008,9,104,54,51.9230769231,12387.35,12.38735,-11.6214003003,1,43,19,44.1860465116,61,35,57.3770491803
09-28-2007--09-22-2008,10,109,58,53.2110091743,3855.23,3.85523,-20.605583956,1,41,20,48.7804878049,68,38,55.8823529412
10-28-2007--10-22-2008,11,102,52,50.9803921569,-14759.28,-14.75928,-41.2508921041,1,39,19,48.7179487179,63,33,52.380952381
11-27-2007--11-21-2008,12,102,50,49.0196078431,-12364.19,-12.36419,-44.2238900189,1,45,21,46.6666666667,57,29,50.8771929825
12-27-2007--12-21-2008,13,100,50,50,-7224.16,-7.22416,-40.279000474,1,44,20,45.4545454545,56,30,53.5714285714
01-26-2008--01-20-2009,14,99,44,44.4444444444,-40527.77,-40.52777,-40.4244306418,0,47,21,44.6808510638,52,23,44.2307692308
02-25-2008--02-19-2009,15,95,41,43.1578947368,-40871.43,-40.87143,-43.0707055997,1,40,19,47.5,55,22,40
03-26-2008--03-21-2009,16,89,38,42.6966292135,-30768.3,-30.7683,-42.4099099099,1,37,17,45.9459459459,52,21,40.3846153846
04-25-2008--04-20-2009,17,79,34,43.0379746835,-33577,-33.577,-40.2363896848,1,29,13,44.8275862069,50,21,42
05-25-2008--05-20-2009,18,74,35,47.2972972973,-22704.53,-22.70453,-34.7252271744,1,29,14,48.275862069,45,21,46.6666666667
06-24-2008--06-19-2009,19,72,34,47.2222222222,-31061.63,-31.06163,-29.8422135834,0,32,16,50,40,18,45
07-24-2008--07-19-2009,20,71,33,46.4788732394,-19790.51,-19.79051,-25.0019918732,1,35,18,51.4285714286,36,15,41.6666666667
08-23-2008--08-18-2009,21,67,32,47.7611940299,-11735.92,-11.73592,-21.9579428211,1,31,17,54.8387096774,36,15,41.6666666667
09-22-2008--09-17-2009,22,66,29,43.9393939394,-5151.82,-5.15182,-11.9613670134,1,35,18,51.4285714286,31,11,35.4838709677
10-22-2008--10-17-2009,23,67,29,43.2835820896,-16467.24,-16.46724,20.2540033131,0,35,18,51.4285714286,32,11,34.375
11-21-2008--11-16-2009,24,61,29,47.5409836066,-4842.8,-4.8428,39.8516096579,0,29,17,58.6206896552,32,12,37.5
12-21-2008--12-16-2009,25,60,31,51.6666666667,7711.41,7.71141,28.0955662761,0,29,19,65.5172413793,31,12,38.7096774194
01-20-2009--01-15-2010,26,57,32,56.1403508772,12486.33,12.48633,41.0450539903,0,30,22,73.3333333333,27,10,37.037037037
02-19-2009--02-14-2010,27,59,34,57.6271186441,6378.09,6.37809,38.1921438713,0,29,21,72.4137931034,30,13,43.3333333333
03-21-2009--03-16-2010,28,55,33,60,-6719.46,-6.71946,41.5491245136,0,30,22,73.3333333333,25,11,44
04-20-2009--04-15-2010,29,55,34,61.8181818182,-1058.27,-1.05827,45.3793599425,0,30,23,76.6666666667,25,11,44
05-20-2009--05-15-2010,30,55,36,65.4545454545,-1563.5,-1.5635,25.8313998453,0,28,23,82.1428571429,27,13,48.1481481481
06-19-2009--06-14-2010,31,51,35,68.6274509804,9030.64,9.03064,18.979791395,0,28,24,85.7142857143,23,11,47.8260869565
07-19-2009--07-14-2010,32,53,35,66.0377358491,14132.54,14.13254,15.2631634273,0,30,23,76.6666666667,23,12,52.1739130435
08-18-2009--08-13-2010,33,61,42,68.8524590164,30269.58,30.26958,9.3046725199,1,36,28,77.7777777778,25,14,56
09-17-2009--09-12-2010,34,59,45,76.2711864407,47090.25,47.09025,4.5307079231,1,36,30,83.3333333333,23,15,65.2173913043
10-17-2009--10-12-2010,35,60,48,80,76671.15,76.67115,6.5761909099,1,39,33,84.6153846154,21,15,71.4285714286
11-16-2009--11-11-2010,36,59,47,79.6610169492,66049.63,66.04963,9.3741570003,1,41,34,82.9268292683,18,13,72.2222222222
12-16-2009--12-11-2010,37,56,41,73.2142857143,42633.19,42.63319,11.6212338594,1,38,29,76.3157894737,18,12,66.6666666667
01-15-2010--01-10-2011,38,55,38,69.0909090909,35265.33,35.26533,11.7388243576,1,38,26,68.4210526316,17,12,70.5882352941
02-14-2010--02-09-2011,39,57,39,68.4210526316,49379.97,49.37997,20.5294332058,1,44,31,70.4545454545,13,8,61.5384615385
03-16-2010--03-11-2011,40,58,37,63.7931034483,44480.58,44.48058,12.3958422816,1,40,27,67.5,18,10,55.5555555556
04-15-2010--04-10-2011,41,58,36,62.0689655172,44748.94,44.74894,9.5391211147,1,40,26,65,18,10,55.5555555556
05-15-2010--05-10-2011,42,58,34,58.6206896552,41138.86,41.13886,19.23650724,1,43,26,60.4651162791,15,8,53.3333333333
06-14-2010--06-09-2011,43,61,34,55.737704918,48223.72,48.22372,18.1638038883,1,44,25,56.8181818182,17,9,52.9411764706
07-14-2010--07-09-2011,44,57,34,59.649122807,15717.93,15.71793,22.5707015896,0,41,26,63.4146341463,16,8,50
08-13-2010--08-08-2011,45,59,33,55.9322033898,63341.17,63.34117,3.6469393408,1,36,21,58.3333333333,23,12,52.1739130435
09-12-2010--09-07-2011,46,58,29,50,35991.22,35.99122,6.7157558552,1,38,19,50,20,10,50
10-12-2010--10-07-2011,47,66,31,46.9696969697,40947.45,40.94745,-1.1110161525,1,38,19,50,28,12,42.8571428571
11-11-2010--11-06-2011,48,72,33,45.8333333333,34417.87,34.41787,3.1619188556,1,43,21,48.8372093023,29,12,41.3793103448
12-11-2010--12-06-2011,49,78,40,51.2820512821,53946.63,53.94663,1.3648041105,1,46,24,52.1739130435,32,16,50
01-10-2011--01-05-2012,50,79,41,51.8987341772,57359.96,57.35996,0.8347771303,1,48,25,52.0833333333,31,16,51.6129032258
02-09-2011--02-04-2012,51,76,41,53.9473684211,45390.59,45.39059,1.7169555981,1,45,25,55.5555555556,31,16,51.6129032258
03-11-2011--03-05-2012,52,74,41,55.4054054054,66659.36,66.65936,4.5169672883,1,48,27,56.25,26,14,53.8461538462
04-10-2011--04-04-2012,53,72,39,54.1666666667,57838.77,57.83877,5.5865921788,1,47,25,53.1914893617,25,14,56
05-10-2011--05-04-2012,54,78,46,58.9743589744,95330.87,95.33087,0.8316773386,1,45,27,60,33,19,57.5757575758
06-09-2011--06-03-2012,55,75,44,58.6666666667,77011.07,77.01107,-0.9582689335,1,43,25,58.1395348837,32,19,59.375
07-09-2011--07-03-2012,56,76,43,56.5789473684,73923.81,73.92381,4.1236644692,1,45,24,53.3333333333,31,19,61.2903225806
08-08-2011--08-02-2012,57,78,44,56.4102564103,34323.4,34.3234,21.7174416533,1,49,29,59.1836734694,29,15,51.724137931
09-07-2011--09-01-2012,58,79,45,56.9620253165,37807.63,37.80763,17.3497381328,1,49,30,61.2244897959,30,15,50
10-07-2011--10-01-2012,59,73,44,60.2739726027,53669.76,53.66976,24.7472128597,1,48,28,58.3333333333,25,16,64
11-06-2011--10-31-2012,60,72,41,56.9444444444,39628.23,39.62823,11.9515285918,1,41,24,58.5365853659,31,17,54.8387096774
12-06-2011--11-30-2012,61,69,37,53.6231884058,36151.98,36.15198,12.5891018533,1,38,23,60.5263157895,31,14,45.1612903226
01-05-2012--12-30-2012,62,71,38,53.5211267606,45550.27,45.55027,9.3642611684,1,39,24,61.5384615385,32,14,43.75
02-04-2012--01-29-2013,63,70,35,50,44789.32,44.78932,12.0565265898,1,37,21,56.7567567568,33,14,42.4242424242
03-05-2012--02-28-2013,64,70,36,51.4285714286,26981.07,26.98107,10.8665447898,1,36,21,58.3333333333,34,15,44.1176470588
04-04-2012--03-30-2013,65,74,39,52.7027027027,41819.66,41.81966,12.0191620192,1,40,24,60,34,15,44.1176470588
05-04-2012--04-29-2013,66,76,40,52.6315789474,29083.95,29.08395,16.2773722628,1,44,28,63.6363636364,32,12,37.5
06-03-2012--05-29-2013,67,75,39,52,24413.4,24.4134,28.9773614364,0,46,29,63.0434782609,29,10,34.4827586207
07-03-2012--06-28-2013,68,75,40,53.3333333333,15221.46,15.22146,16.7438069455,0,42,27,64.2857142857,33,13,39.3939393939
08-02-2012--07-28-2013,69,68,36,52.9411764706,37488.56,37.48856,23.7631733021,1,40,24,60,28,12,42.8571428571
09-01-2012--08-27-2013,70,63,33,52.380952381,12939.78,12.93978,15.8122385308,0,35,21,60,28,12,42.8571428571
10-01-2012--09-26-2013,71,64,33,51.5625,17582.67,17.58267,17.5586269008,1,38,22,57.8947368421,26,11,42.3076923077
10-31-2012--10-26-2013,72,64,34,53.125,32264.45,32.26445,24.4782454899,1,39,24,61.5384615385,25,10,40
11-30-2012--11-25-2013,73,61,31,50.8196721311,19752.95,19.75295,27.0655270655,0,41,23,56.0975609756,20,8,40
12-30-2012--12-25-2013,74,58,29,50,-1624.86,-1.62486,28.4530580718,0,39,21,53.8461538462,19,8,42.1052631579
01-29-2013--01-24-2014,75,62,30,48.3870967742,-3925.81,-3.92581,18.7375547591,0,40,20,50,22,10,45.4545454545
02-28-2013--02-23-2014,76,60,29,48.3333333333,-24804.81,-24.80481,21.2914715388,0,39,21,53.8461538462,21,8,38.0952380952
03-30-2013--03-25-2014,77,62,30,48.3870967742,-11697.98,-11.69798,19.3912207626,0,34,18,52.9411764706,28,12,42.8571428571
04-29-2013--04-24-2014,78,58,26,44.8275862069,-9570.93,-9.57093,17.9096045198,0,33,15,45.4545454545,25,11,44
05-29-2013--05-24-2014,79,66,32,48.4848484848,-12011.15,-12.01115,15.2100229996,0,37,19,51.3513513514,29,13,44.8275862069
06-28-2013--06-23-2014,80,60,28,46.6666666667,-12594.67,-12.59467,22.1044757512,0,38,20,52.6315789474,22,8,36.3636363636
07-28-2013--07-23-2014,81,63,30,47.619047619,-8023.65,-8.02365,17.8243074915,0,40,22,55,23,8,34.7826086957
08-27-2013--08-22-2014,82,67,33,49.2537313433,-3862.47,-3.86247,21.9555501133,0,42,23,54.7619047619,25,10,40
09-26-2013--09-21-2014,83,68,31,45.5882352941,-17723.59,-17.72359,18.2745005598,0,40,22,55,28,9,32.1428571429
10-26-2013--10-21-2014,84,65,31,47.6923076923,-8479.38,-8.47938,10.1231345401,0,38,21,55.2631578947,27,10,37.037037037
11-25-2013--11-20-2014,85,65,33,50.7692307692,16723.04,16.72304,13.8127664286,1,39,25,64.1025641026,26,8,30.7692307692
12-25-2013--12-20-2014,86,69,32,46.3768115942,1188.4,1.1884,12.3276495064,0,38,23,60.5263157895,31,9,29.0322580645
,,,,,,,,,,,,,,
,,,,,,66.2790697674,,65.1162790698,,,,,,
